19 21
#######______________
#..P..###############
#....J..............#
#..T.H.C..CCCCCC....#
#...................#
#.....###############
##...##______________
_#...#_______________
_#...#_______________
_#...#_______________
_#...#_______________
_#...#_______________
##.C.##_______#######
#.....#########.....#
#...................#
#......C.......S..M.#
#...................#
#.....#########.....#
##...##_______#######

IF YOU WANT TO CHANGE THE MAP, PLEASE MAKE IT AT LEAST 2 BLOCK WIDE FOR PREVENT UNEXPECTED ERROR